# Resources from graph.properties
alreadyConnected=Nodes already connected
cancel=取消
close=关闭
collapse-expand=Collapse/Expand
containsValidationErrors=Contains validation errors
done=完成
doubleClickOrientation=Doubleclick to Change Orientation
error=错误
errorSavingFile=Error saving file
ok=确定
updatingDocument=Updating Document. Please wait...
updatingSelection=Updating Selection. Please wait...
# Custom resources
about=关于
actualSize=实际尺寸
add=添加
addLayer=添加层
addProperty=添加属性
addToExistingDrawing=Add to Existing Drawing
addWaypoint=添加路点
advanced=高级
align=对齐
alignment=对齐
allChangesLost=All changes will be lost!
angle=角度
apply=应用
arc=Arc
arrange=排列
arrow=箭头
arrows=箭头组
automatic=自动
autosave=自动保存
autosize=自动尺寸
back=返回
background=背景
backgroundColor=背景颜色
backgroundImage=背景图片
basic=基础
block=块
blockquote=引用
bold=加粗
border=描边
borderWidth=粗细
borderColor=颜色
bottom=底
bottomAlign=对齐底部
bottomLeft=左下
bottomRight=右下
bulletedList=列表
cannotOpenFile=无法打开文档
center=居中
change=改变
changeOrientation=改变方向
circle=圆形
classic=经典
clearDefaultStyle=清除默认样式
clearWaypoints=清除所有路点
clipart=插图
collapse=折叠
collapseExpand=折叠/展开
collapsible=可折叠
comic=卡通风格
connect=连接
connection=连线
connectionPoints=联结点
connectionArrows=联结箭头
constrainProportions=约束比例
copy=复制
copyConnect=Copy on Connect
copySize=复制尺寸
create=创建
curved=曲线
custom=自定义
cut=剪切
dashed=虚线
decreaseIndent=减少缩进
default=默认
delete=删除
deleteColumn=删除列
deleteRow=删除行
diagram=图表
diamond=菱形
diamondThin=菱形(细)
direction=方向
distribute=分散
divider=分隔线
documentProperties=文档属性
dotted=点线
dpi=DPI
drawing=绘图{1}
drawingEmpty=绘图内容为空
drawingTooLarge=绘图太大
duplicate=复制
duplicateIt=复制 {1}
east=东
edit=编辑
editData=编辑数据
editDiagram=编辑图表
editImage=编辑图像
editLink=编辑链接
editStyle=编辑样式
editTooltip=编辑贴士
enterGroup=编辑组
enterValue=编辑数值
enterName=输入名称
enterPropertyName=输入属性名称
entityRelation=实体关系
exitGroup=退出组
expand=展开
export=导出
extras=附加内容
file=文件
fileNotFound=文件未找到
filename=文件名
fill=填充
fillColor=填充颜色
fitPage=填充整页
fitPageWidth=整页宽
fitTwoPages=填充两页
fitWindow=适应窗体
flip=翻转
flipH=水平翻转
flipV=垂直翻转
font=字体
fontFamily=字体
fontColor=颜色
fontSize=尺寸
format=格式
formatPanel=格式面板
general=普通
formatPdf=PDF
formatPng=PNG
formatGif=GIF
formatJpg=JPEG
formatSvg=SVG
formatXml=XML
formatted=已格式化
formattedText=格式化文本
gap=间距
glass=玻璃
general=通用形状
global=全局
gradient=渐变
gradientColor=颜色
grid=网格
gridSize=网格尺寸
group=组
guides=引导线
heading=Heading
height=高
help=帮助
hide=隐藏
hideIt=隐藏 {1}
hidden=隐藏
home=首页
horizontal=水平
horizontalFlow=Horizontal Flow
horizontalTree=水平树
html=HTML
id=ID
image=图像
images=图像
import=导入
increaseIndent=增加缩进
insert=插入
insertColumnBefore=从左边插入列
insertColumnAfter=从右边插入列
insertHorizontalRule=插入水平尺
insertImage=插入图像
insertLink=插入链接
insertRowBefore=从上边插入行
insertRowAfter=从下边插入行
invalidInput=输入不合法
invalidName=名称不合法
invalidOrMissingFile=文件不合法或未找到
isometric=透视
italic=斜体
layers=层
landscape=横向
laneColor=Lanecolor
layout=布局
left=左
leftAlign=左对齐
leftToRight=从左到右
line=线
link=链接
lineJumps=Line jumps
lineend=终点
lineheight=线高
linestart=起点
linewidth=线宽
loading=加载中
lockUnlock=加锁/解锁
manual=手工
middle=居中
misc=杂项
more=更多
moreResults=更多结果
move=移动
moveSelectionTo=移动选区到 {1}
navigation=导航
new=新建
noColor=无色
noFiles=没有文件
noMoreResults=没有更多结果
none=无
noResultsFor=没有针对'{1}'的结果
normal=普通
north=北
numberedList=Numbered List
opacity=透明度
open=打开
openArrow=打开箭头
openFile=打开文件
openLink=打开链接
openSupported=支持本软件导出的.XML格式的文件
openInNewWindow=新窗口中打开
openInThisWindow=当前窗口中打开
options=选项
organic=Organic
orthogonal=直线
outline=导览
oval=椭圆
pages=页
pageView=页面视图
pageScale=页面放缩
pageSetup=页面设定
panTooltip="空格+拖动"来滚动
paperSize=文档尺寸
paste=粘贴
pasteHere=粘贴到这里
pasteSize=粘贴尺寸
pattern=图案
perimeter=Perimeter
placeholders=占位
plusTooltip=点击连接或克隆 (ctrl+点击 克隆, shift+点击 连接). 拖动克隆 (ctrl+拖动 克隆).
portrait=纵向
position=位置
posterPrint=海报印刷
preview=预览
print=打印
radialTree=环形树状图
redo=重做
removeFormat=清除格式
removeFromGroup=从组中移除
removeIt=删除 {1}
removeWaypoint=删除路点
rename=重命名
renameIt=重命名 {1}
replace=替换
replaceIt={1} 已经存在. 是否要替换?
replaceExistingDrawing=替换已经存在的绘图
reset=重置
resetView=视图重置
reverse=反转
right=右
rightAlign=右对齐
rightToLeft=从右到左
rotate=旋转
rotateTooltip=点击并拖动可旋转, 点击旋转按钮是按90度去旋转
rotation=旋转度
rounded=圆角
save=保存
saveAs=另存为
saved=已保存
scrollbars=滚动条
search=搜索
searchShapes=搜索形状
selectAll=全选
selectEdges=选择边
selectFont=选择一个字体
selectNone=取消选择
selectVertices=选择一个顶点
setAsDefaultStyle=设为默认样式
shadow=阴影
shape=形状
sharp=直角
sidebarTooltip=点击展开. 将图形拖入绘图中. Shift+点击可以进行选择. Alt+点击可以插入并连接.
simple=简单
simpleArrow=简单箭头
size=尺寸
solid=实线
sourceSpacing=Source Spacing
south=南
spacing=字间距
straight=Straight
strikethrough=Strikethrough
strokeColor=颜色
style=样式
subscript=下标
superscript=上标
table=表格
targetSpacing=Target Spacing
text=文本
textAlignment=对齐
textOpacity=透明度
toBack=后移
toFront=前移
tooltips=小贴士
top=顶
topAlign=顶部对齐
topLeft=左上
topRight=右上
transparent=透明度
turn=仅能按90°旋转
uml=UML
underline=下划线
undo=撤销
ungroup=解组
url=URL
untitledLayer=未命名层
vertical=垂直
verticalFlow=Vertical Flow
verticalTree=Vertical Tree
view=视图
waypoints=路点
west=西
width=宽
wordWrap=换行
writingDirection=书写方向
zoom=放缩
zoomIn=放大
zoomOut=缩小
